14
10
10
1111111111
1000000001
1000000001
1000003001
1000000001
1000000001
1000000001
1011000001
1000000001
1111111111
Guards:
0
