26
20
20
11111111111111111111
10000000000000000001
10000000000000000001
10000000000000000001
10000000000000000001
10000000000000000001
10000000000000000001
10000000000000000001
10000000000000000001
10001111111111110001
10000000000000000001
10001111111111110001
10000000000000000001
10000000000000000001
10000000000000000001
10000000000000000001
10000000000000000001
10000000000000000001
10000000000010000001
11111111111111111111
Begin punt:
9,1;
Eind punt:
9,8;
spots:
0
cameras:
4
1,1;
18,1;
18,18;
1,18;
Guards:
2
4,10;5,10;6,10;7,10;8,10;9,10;10,10;11,10;12,10;13,10;14,10;15,10;16,10;16,9;16,8;16,7;16,6;16,5;16,4;16,3;15,3;14,3;13,3;12,3;11,3;10,3;9,3;8,3;7,3;6,3;5,3;4,3;3,3;3,4;3,5;3,6;3,7;3,8;3,9;3,10;
18,18;18,17;18,16;18,15;18,14;18,13;
