a5ir783n!f78gds3b?54sdfg>sdfg549fd#sh
40
40
1111111111111111111111111111111111111111
1000000000000000000000000000000000000011
1000000000000000000000000001110000000001
1000000000000000010000000001110000000001
1001110000000000010000000000001110000001
1001010011110000010001100000001100000001
1001011000010000010000011100001100000001
1001011000010000010000001100011100000001
1001011000011111111111001000011110000001
1001011000000000000000001000011110000001
1001011000000000000000001000011110001011
1001000000000110000000001000011010001011
1000000000000111111110010000010011211011
1000011111111100000010010000010010000001
1000000000000000000010010000010000000001
1000000000000000000010010010010001000001
1001000000000000000010010010010001000001
1001000000000000000010010010010001100001
1001010000000000000010010010010000100001
1001011111111111000010010011010000000001
1001111000000001000010010001010000000001
1001101001100001000010010101110000000001
1001101001011111000010010100011111000001
1001001001000001000010010100001001000001
1001001001000000000010010100001001000001
1000001001000000000010010010001001000001
1000001001000000000010010011111001000001
1001001001111111000010010000010001000001
1001000000000000000010010000010001000001
1001000000000000000010010000010001000001
1001000111110000000010010000010001000001
1001000100010001000010010011010001000001
1001000100010001000010010001010001000001
1001000100010001000010010001010001000001
1001000000010001000010010001010011000001
1001000000010001000010010001011101000001
1001111110010001000000010001000001000001
1000000001110000000000010001111111000001
1000000000000000000000010000000001000001
1111111111111111111111111111111111111111
Begin punt:
1,38;
Eind punt:
38,38;
spots:
8
2,7;
1,25;
15,17;
31,30;
38,26;
33,3;
20,3;
13,34;
cameras:
24
21,15;
22,15;
11,16;
17,23;
11,25;
31,33;
32,27;
36,21;
34,7;
19,2;
12,4;
5,2;
1,15;
3,38;
20,36;
16,31;
26,29;
26,11;
25,2;
38,2;
37,5;
37,10;
37,11;
37,12;
controlCenter:
4
1,35;
17,16;
15,3;
37,7;
Guards:
5
35,25;35,26;35,27;35,28;35,29;35,30;35,31;35,32;35,33;35,34;36,34;37,34;
18,28;18,27;18,26;18,25;18,24;18,23;18,22;18,21;18,20;18,19;18,18;18,17;17,17;16,17;15,17;14,17;13,17;12,17;
2,11;2,10;2,9;2,8;2,7;2,6;2,5;2,4;2,3;2,2;3,2;4,2;5,2;6,2;7,2;8,2;9,2;10,2;11,2;12,2;
5,29;5,30;5,31;5,32;5,33;5,34;5,35;6,35;7,35;8,35;8,34;9,34;
27,11;27,10;27,9;27,8;27,7;27,6;27,5;27,4;26,4;26,5;25,5;24,5;23,5;
Keys:
1
7,2;34,12;
