a5ir783n!f78gds3b?54sdfg>sdfg549fd#sh
20
20
11111111111111111111
10000000000000000101
11111111011111110101
10000001010000010101
10000001010011110101
10000001010010000101
10000001010010111101
10000001011010001001
10000001011011101001
10000001011000101001
10000001010000101001
10000001010000101001
10000001010000101001
10000001011111101001
10000001000000000001
10000001111111110001
10000000000000000001
10000000000000000001
10000000000000000001
11111111111111111111
Begin punt:
1,4;
Eind punt:
2,4;
spots:
0
cameras:
1
16,14;
Guards:
4
1,1;2,1;3,1;4,1;5,1;6,1;7,1;8,1;
2,3;2,4;2,5;2,6;2,7;2,8;2,9;2,10;2,11;2,12;
18,17;18,16;18,15;18,14;18,13;18,12;18,11;
9,18;10,18;11,18;12,18;13,18;14,18;
Keys:
0
