12
10
10
0110111000
0101101110
1100000110
1000000110
1000000011
1000101111
1010001101
1000000000
1000100101
1111111111
