25
20
20
00000000000000000000
00010100000000000000
00010100000000000000
00010100000000000000
00010100000000000000
00010100000000000000
00010100000000000000
00010100000000000000
00010100000000000000
00010100000000000000
00010100000000000000
00010100000000000000
00010100000000000000
00010100000000000000
00010100000000000000
00010111111111100000
00010000000000000000
00011111111111100000
00000000011111000000
00000000000000000000
Guards:
1
4,1;4,2;4,3;4,4;4,5;4,6;4,7;4,8;4,9;4,10;4,11;4,12;4,13;4,14;4,15;4,16;5,16;6,16;7,16;8,16;9,16;10,16;11,16;12,16;13,16;14,16;
