a5ir783n!f78gds3b?54sdfg>sdfg549fd#sh
20
20
11111111111111111111
10000000000000000011
10000000000000000020
10000000000000000010
10000000000000000011
10000000000000000001
10000000000000000001
10000000000000000001
10000000000000000001
10000000000000000001
10000000000000000001
10000000000000000001
10000000000000000001
10000000000000000001
10000000000000000001
10000000000000000001
10000000000000000001
10000000000000000001
10000000000000000001
11111111111111111111
Begin punt:
18,15;
Eind punt:
19,2;
spots:
7
2,3;
3,13;
7,9;
12,2;
13,14;
7,16;
13,7;
cameras:
3
10,12;
9,4;
17,18;
controlCenter:
1
17,8;
Guards:
1
2,9;2,10;2,11;2,12;3,12;3,13;3,14;2,14;2,15;2,16;3,16;3,17;4,17;5,17;6,17;7,17;8,17;
Keys:
1
2,1;18,2;
