a5ir783n!f78gds3b?54sdfg>sdfg549fd#sh
50
50
00000000000000000000000000000000000000000000000000
00000000000000000000000000000000000110000000000000
00000000000000000000000000000000011101000000000000
00000000000000000000000000000001100000100000000000
00000000000000000000000000000010000000100000000000
00000000000000000000000000001100000011100000000000
00000000000000000000000000000111111110000000000000
00000000000000000000000000000000000000000000000000
00000000000000000000000000000000000000000000000000
00000000000000000000000111000000000000000000000000
00000000000000000000001101100000111110000000000000
00000000000000000000010001110111000001000000000000
00000000000000000000010001011001100000100000000000
00000000000000000000110001010000111111100000000000
00000000000000000001111000010000000000000000000000
00000000000000000001011000010000000000000000000000
00000000000000000011011100011000000000000000000000
00000000000000000010000110001000000000000000000000
00000000000000000100000011111000000000000000000000
00000000000000000100000000001000000000000000000000
00000000000000000100000000010000000000000000000000
00000000000000000100000000010000000000000000000000
00000000000000000100000000010000000000000000000000
00000000000000000100000000010000000000000000000000
00000000000000001100000000010000000000000000000000
00000000000000001000000000010000000000000000000000
00000000000000001000000000010000000000000000000000
00000000000000001000000000010000000000000000000000
00000000000000001000000000010000000000000000000000
00000000000000001000000000010000000000000000000000
00000000000011111100000000110000000000000000000000
00000000001110000110000000100000000000000000000000
00000000001000000011000000100000000000000000000000
00000000001000000001000000100000000000000000000000
00000000001100000001000000111100000000000000000000
00000000000110000011000000110011000000000000000000
00000000000010000010011101111101000000000000000000
00000000000011101110010001100001100000000000000000
00000000000000111000010000000000100000000000000000
00000000000000000000010000000001100000000000000000
00000000000000000000011000000001000000000000000000
00000000000000000000001100000001000000000000000000
00000000000000000000000110000001000000000000000000
00000000000000000000000001100110000000000000000000
00000000000000000000000000011100000000000000000000
00000000000000000000000000000000000000000000000000
00000000000000000000000000000000000000000000000000
00000000000000000000000000000000000000000000000000
00000000000000000000000000000000000000000000000000
00000000000000000000000000000000000000000000000000
Begin punt:
9,9;
Eind punt:
35,30;
spots:
0
cameras:
3
1,34;
3,38;
9,42;
Guards:
1
2,6;2,7;2,8;2,9;2,10;2,11;2,12;2,13;2,14;2,15;2,16;2,17;2,18;2,19;2,20;2,21;2,22;2,23;3,23;3,22;3,21;3,20;3,19;3,18;3,17;4,17;4,16;4,15;4,14;5,14;6,14;7,14;7,15;7,16;
Keys:
0
